dd_mm_yyyy;daily_cases;total_cases;daily_recoveries;total_recoveries;daily_deaths;total_deaths;daily_tests;daily_first_dose_vaccinations;daily_second_dose_vaccinations;total_second_dose_vaccinations;total_boosters;total_vaccinations;vaccine_type;daily_deaths_over_total_second_dose_vaccinations_per_million;daily_cases_over_total_second_dose_vaccinations_per_million
13.01.2021;9554;2355839;9463;2227927;173;23325;173603;0;0;0;0;0;Sinovac;N/A;N/A
14.01.2021;8962;2364801;9011;2236938;170;23495;169847;279452;0;0;0;279452;Sinovac;N/A;N/A
15.01.2021;8314;2373115;9109;2246047;169;23664;167211;337200;0;0;0;616652;Sinovac;N/A;N/A
16.01.2021;7550;2380665;8005;2254052;168;23832;156792;60251;0;0;0;676903;Sinovac;N/A;N/A
17.01.2021;6436;2387101;8812;2262864;165;23997;148636;29548;0;0;0;706451;Sinovac;N/A;N/A
18.01.2021;5862;2392963;7905;2270769;164;24161;151342;125961;0;0;0;832412;Sinovac;N/A;N/A
19.01.2021;6818;2399781;7218;2277987;167;24328;175133;118223;0;0;0;950635;Sinovac;N/A;N/A
20.01.2021;6435;2406216;5932;2283919;159;24487;168894;101858;0;0;0;1052493;Sinovac;N/A;N/A
21.01.2021;6289;2412505;6113;2290032;153;24640;165109;67765;0;0;0;1120258;Sinovac;N/A;N/A
22.01.2021;5967;2418472;6018;2296050;149;24789;163342;81954;0;0;0;1202212;Sinovac;N/A;N/A
23.01.2021;5856;2424328;5811;2301861;144;24933;152758;24671;0;0;0;1226883;Sinovac;N/A;N/A
24.01.2021;5277;2429605;5860;2307721;140;25073;148425;17770;0;0;0;1244653;Sinovac;N/A;N/A
25.01.2021;5642;2435247;6682;2314403;137;25210;151109;58100;0;0;0;1302753;Sinovac;N/A;N/A
26.01.2021;7103;2442350;8108;2322511;134;25344;180303;107520;0;0;0;1410273;Sinovac;N/A;N/A
27.01.2021;7489;2449839;8803;2331314;132;25476;179419;112307;0;0;0;1522580;Sinovac;N/A;N/A
28.01.2021;7279;2457118;8902;2340216;129;25605;173210;174995;0;0;0;1697575;Sinovac;N/A;N/A
29.01.2021;6912;2464030;8093;2348309;131;25736;165094;230776;0;0;0;1928351;Sinovac;N/A;N/A
30.01.2021;6871;2470901;7100;2355409;129;25865;148785;32509;0;0;0;1960860;Sinovac;N/A;N/A
31.01.2021;6562;2477463;7006;2362415;128;25993;136418;25377;0;0;0;1986237;Sinovac;N/A;N/A
1.02.2021;7719;2485182;8016;2370431;124;26117;141703;150062;0;0;0;2136299;Sinovac;N/A;N/A
2.02.2021;7795;2492977;8639;2379070;120;26237;140120;92934;0;0;0;2229233;Sinovac;N/A;N/A
3.02.2021;8102;2501079;8314;2387384;117;26354;148192;114047;0;0;0;2343280;Sinovac;N/A;N/A
4.02.2021;7909;2508988;8815;2396199;113;26467;145067;157526;0;0;0;2500806;Sinovac;N/A;N/A
5.02.2021;7901;2516889;8217;2404416;110;26577;142538;58996;0;0;0;2559802;Sinovac;N/A;N/A
6.02.2021;7897;2524786;8089;2412505;108;26685;137649;41915;0;0;0;2601717;Sinovac;N/A;N/A
7.02.2021;6670;2531456;28201;2440706;112;26797;129715;8779;0;0;0;2610496;Sinovac;N/A;N/A
8.02.2021;8103;2539559;8567;2449273;103;26900;139378;53707;0;0;0;2664203;Sinovac;N/A;N/A
9.02.2021;8636;2548195;-11891;2437382;98;26998;137712;68506;0;0;0;2732709;Sinovac;N/A;N/A
10.02.2021;8642;2556837;119455;2556837;95;27093;135867;62407;0;0;0;2795116;Sinovac;N/A;N/A
11.02.2021;7590;2564427;-103741;2453096;94;27187;130313;51009;0;0;0;2846125;Sinovac;N/A;N/A
12.02.2021;7763;2572190;8108;2461204;97;27284;129630;3067822;336532;336532;0;3404354;Sinovac;288;23068
13.02.2021;7706;2579896;7215;2468419;93;27377;123305;3253005;120359;456891;0;3709896;Sinovac;204;16866
14.02.2021;6287;2586183;6910;2475329;94;27471;104108;3336164;32046;488937;0;3825101;Sinovac;192;12859
15.02.2021;7945;2594128;7106;2482435;91;27562;116452;3608148;84942;573879;0;4182027;Sinovac;159;13844
16.02.2021;7906;2602034;7189;2489624;90;27652;115794;3984622;72283;646162;0;4630784;Sinovac;139;12235
17.02.2021;7325;2609359;7209;2496833;86;27738;117121;4477432;100008;746170;0;5223602;Sinovac;115;9817
18.02.2021;7241;2616600;7217;2504050;83;27821;115406;5028179;120946;867116;0;5895295;Sinovac;96;8351
19.02.2021;7419;2624019;7498;2511548;82;27903;116674;5384983;109600;976716;0;6361699;Sinovac;84;7596
20.02.2021;7857;2631876;7210;2518758;80;27983;118911;5503094;53700;1030416;0;6533510;Sinovac;78;7625
21.02.2021;6546;2638422;5002;2523760;77;28060;101105;5517993;23421;1053837;0;6571830;Sinovac;73;6212
22.02.2021;8104;2646526;5690;2529450;78;28138;118816;5738471;44994;1098831;0;6837302;Sinovac;71;7375
23.02.2021;9107;2655633;5546;2534996;75;28213;123734;6106522;84145;1182976;0;7289498;Sinovac;63;7698
24.02.2021;9561;2665194;5297;2540293;72;28285;124015;6352410;84309;1267285;0;7619695;Sinovac;57;7544
25.02.2021;9572;2674766;6210;2546503;73;28358;126527;6582239;130202;1397487;0;7979726;Sinovac;52;6849
26.02.2021;9205;2683971;10282;2556785;74;28432;128387;6745147;156171;1553658;0;8298805;Sinovac;48;5925
27.02.2021;9193;2693164;8938;2565723;71;28503;125716;6854642;106475;1660133;0;8514775;Sinovac;43;5538
28.02.2021;8424;2701588;6511;2572234;66;28569;109639;6869923;17819;1677952;0;8547875;Sinovac;39;5020
1.03.2021;9891;2711479;5947;2578181;69;28638;130536;6975558;121208;1799160;0;8774718;Sinovac;38;5498
2.03.2021;11837;2723316;7892;2586073;68;28706;135291;7123722;150758;1949918;0;9073640;Sinovac;35;6071
3.03.2021;11520;2734836;7191;2593264;65;28771;138018;7240515;127113;2077031;0;9317546;Sinovac;31;5546
4.03.2021;11322;2746158;7873;2601137;68;28839;137885;7353536;129471;2206502;0;9560038;Sinovac;31;5131
5.03.2021;11302;2757460;7711;2608848;62;28901;138214;7446337;103450;2309952;0;9756289;Sinovac;27;4893
6.03.2021;11770;2769230;7291;2616139;64;28965;138592;7509923;63732;2373684;0;9883607;Sinovac;27;4959
7.03.2021;11187;2780417;7785;2623924;65;29030;129299;7524943;18721;2392405;0;9917348;Sinovac;27;4676
8.03.2021;13215;2793632;8106;2632030;64;29094;139429;7565023;44552;2436957;0;10001980;Sinovac;26;5423
9.03.2021;13755;2807387;8639;2640669;66;29160;140828;7676519;109518;2546475;0;10222994;Sinovac;26;5402
10.03.2021;14556;2821943;9193;2649862;67;29227;145130;7745480;68328;2614803;0;10360283;Sinovac;26;5567
11.03.2021;14046;2835989;9231;2659093;63;29290;146386;7807838;79853;2694656;0;10502494;Sinovac;23;5213
12.03.2021;14941;2850930;11180;2670273;66;29356;148856;7858565;189056;2883712;0;10742277;Sinovac;23;5181
13.03.2021;15082;2866012;15287;2685560;65;29421;150098;7887544;152028;3035740;0;10923284;Sinovac;21;4968
14.03.2021;13378;2879390;15516;2701076;68;29489;132425;7892795;63560;3099300;0;10992095;Sinovac;22;4316
15.03.2021;15503;2894893;15893;2716969;63;29552;151113;7911946;250366;3349666;0;11261612;Sinovac;19;4628
16.03.2021;16749;2911642;17893;2734862;71;29623;158386;7948320;398310;3747976;0;11696296;Sinovac;19;4469
17.03.2021;18912;2930554;17161;2752023;73;29696;167526;7977222;417047;4165023;0;12142245;Sinovac;18;4541
18.03.2021;20049;2950603;18615;2770638;81;29777;184452;7991510;274949;4439972;0;12431482;Sinovac;18;4516
19.03.2021;21030;2971633;18119;2788757;87;29864;187859;8007734;396871;4836843;0;12844577;Sinovac;18;4348
20.03.2021;21061;2992694;18815;2807572;95;29959;190129;8016078;176833;5013676;0;13029754;Sinovac;19;4201
21.03.2021;20428;3013122;17615;2825187;102;30061;189906;8017698;26348;5040024;0;13057722;Sinovac;20;4053
22.03.2021;22216;3035338;19494;2844681;117;30178;201215;8045789;180139;5220163;0;13265952;Sinovac;22;4256
23.03.2021;26182;3061520;19201;2863882;138;30316;211848;8091685;277319;5497482;0;13589167;Sinovac;25;4763
24.03.2021;29762;3091282;17761;2881643;146;30462;221738;8133043;339342;5836824;0;13969867;Sinovac;25;5099
25.03.2021;28731;3120013;19186;2900829;157;30619;222753;8163156;227430;6064254;0;14227410;BioNTech, Sinovac;26;4738
26.03.2021;29081;3149094;20208;2921037;153;30772;220985;8195554;231439;6295693;0;14491247;BioNTech, Sinovac;24;4619
27.03.2021;30021;3179115;18892;2939929;151;30923;223214;8217124;139842;6435535;0;14652659;BioNTech, Sinovac;23;4665
28.03.2021;29058;3208173;17164;2957093;153;31076;220109;8293998;71426.5;6506962;0;14800960;BioNTech, Sinovac;24;4466
29.03.2021;32404;3240577;18015;2975108;154;31230;225511;8370872;71426.5;6578388;0;14949260;BioNTech, Sinovac;23;4926
30.03.2021;37303;3277880;19925;2995033;155;31385;235298;8614368;108706;6687094;0;15301462;BioNTech, Sinovac;23;5578
31.03.2021;39302;3317182;19193;3014226;152;31537;240012;8994454;153239;6840333;0;15834787;BioNTech, Sinovac;22;5746
1.04.2021;40806;3357988;20817;3035043;176;31713;243738;9206500;101850;6942183;0;16148683;BioNTech, Sinovac;25;5878
2.04.2021;42308;3400296;24419;3059462;179;31892;248968;9313746;61241;7003424;0;16317170;BioNTech, Sinovac;26;6041
3.04.2021;44756;3445052;23214;3082676;186;32078;249126;9478896;120599;7124023;0;16602919;BioNTech, Sinovac;26;6282
4.04.2021;41998;3487050;22674;3105350;185;32263;246210;9546643;12401;7136424;0;16683067;BioNTech, Sinovac;26;5885
5.04.2021;42551;3529601;25627;3130977;193;32456;245496;9796506;60644;7197068;0;16993574;BioNTech, Sinovac;27;5912
6.04.2021;49584;3579185;28498;3159475;211;32667;271547;10088238;82569;7279637;0;17367875;BioNTech, Sinovac;29;6811
7.04.2021;54740;3633925;35503;3194978;276;32943;302108;10359390;65861;7345498;0;17704888;BioNTech, Sinovac;38;7452
8.04.2021;55941;3689866;37914;3232892;258;33201;304492;10627037;117248;7462746;0;18089783;BioNTech, Sinovac;35;7496
9.04.2021;55791;3745657;35786;3268678;253;33454;305103;10777451;80187;7542933;0;18320384;BioNTech, Sinovac;34;7396
10.04.2021;52676;3798333;32539;3301217;248;33702;302735;10865731;36690;7579623;0;18445354;BioNTech, Sinovac;33;6950
11.04.2021;50678;3849011;30194;3331411;237;33939;294274;10907432;7741;7587364;0;18494796;BioNTech, Sinovac;31;6679
12.04.2021;54562;3903573;41218;3372629;243;34182;301068;11108847;32767;7620131;0;18728978;BioNTech, Sinovac;32;7160
13.04.2021;59187;3962760;52104;3424733;273;34455;306563;11388406;54221;7674352;0;19062758;BioNTech, Sinovac;36;7712
14.04.2021;62797;4025557;55413;3480146;279;34734;310420;11556291;42032;7716384;0;19272675;BioNTech, Sinovac;36;8138
15.04.2021;61400;4086957;54894;3535040;297;35031;318217;11708135;20750;7737134;0;19445269;BioNTech, Sinovac;38;7936
16.04.2021;63082;4150039;56510;3591550;289;35320;320078;12038403;36237;7773371;0;19811774;BioNTech, Sinovac;37;8115
17.04.2021;62606;4212645;52184;3643734;288;35608;319316;12151728;12260;7785631;0;19937359;BioNTech, Sinovac;37;8041
18.04.2021;55802;4268447;43856;3687590;318;35926;301243;12182430;2154;7787785;0;19970215;BioNTech, Sinovac;41;7165
19.04.2021;55149;4323596;48947;3736537;341;36267;318869;12260361;27358;7815143;0;20075504;BioNTech, Sinovac;44;7057
20.04.2021;61028;4384624;55592;3792129;346;36613;322128;12426580;41504;7856647;0;20283227;BioNTech, Sinovac;44;7768
21.04.2021;61967;4446591;52213;3844342;362;36975;318839;12590582;30456;7887103;0;20477685;BioNTech, Sinovac;46;7857
22.04.2021;54791;4501382;65593;3909935;354;37329;312109;12796678;45194;7932297;0;20728975;BioNTech, Sinovac;45;6907
23.04.2021;49438;4550820;60176;3970111;343;37672;302091;12940482;14648;7946945;0;20887427;BioNTech, Sinovac;43;6221
24.04.2021;40596;4591416;52297;4022408;339;38011;281183;13114373;7085;7954030;0;21068403;BioNTech, Sinovac;43;5104
25.04.2021;38553;4629969;51236;4073644;347;38358;260280;13171984;4949;7958979;0;21130963;BioNTech, Sinovac;44;4844
26.04.2021;37312;4667281;48027;4121671;353;38711;268893;13287707;148099;8107078;0;21394785;BioNTech, Sinovac;44;4602
27.04.2021;43301;4710582;45592;4167263;346;39057;282192;13383037;188346;8295424;0;21678461;BioNTech, Sinovac;42;5220
28.04.2021;40444;4751026;45198;4212461;341;39398;283261;13512810;324569;8619993;0;22132803;BioNTech, Sinovac;40;4692
29.04.2021;37674;4788700;43253;4255714;339;39737;278108;13646398;301781;8921774;0;22568172;BioNTech, Sinovac;38;4223
30.04.2021;31891;4820591;68183;4323897;394;40131;265287;13712254;182863;9104637;0;22816891;BioNTech, Sinovac;43;3503
1.05.2021;28817;4849408;81302;4405199;373;40504;242194;13752107;42302;9146939;0;22899046;BioNTech, Sinovac;41;3150
2.05.2021;25980;4875388;75182;4480381;340;40844;240145;13800405;59390;9206329;0;23006734;BioNTech, Sinovac;37;2822
3.05.2021;24733;4900121;35438;4515819;347;41191;243648;13933868;154280;9360609;0;23294477;BioNTech, Sinovac;37;2642
4.05.2021;28997;4929118;38218;4554037;336;41527;241747;14132161;236343;9596952;0;23729113;BioNTech, Sinovac;35;3021
5.05.2021;26476;4955594;35464;4589501;356;41883;229491;14264014;242917;9839869;0;24103883;BioNTech, Sinovac;36;2691
6.05.2021;22388;4977982;37298;4626799;304;42187;253382;14391595;236255;10076124;0;24467719;BioNTech, Sinovac;30;2222
7.05.2021;20107;4998089;35529;4662328;278;42465;251194;14476881;138039;10214163;0;24691044;BioNTech, Sinovac;27;1969
8.05.2021;18052;5016141;28896;4691224;281;42746;228873;14545524;93666;10307829;0;24853353;BioNTech, Sinovac;27;1751
9.05.2021;15191;5031332;25694;4716918;283;43029;197468;14585980;24964;10332793;0;24918773;BioNTech, Sinovac;27;1470
10.05.2021;13604;5044936;26953;4743871;282;43311;213863;14618167;67118;10399911;0;25018078;BioNTech, Sinovac;27;1308
11.05.2021;14497;5059433;22253;4766124;278;43589;226452;14660551;118212;10518123;0;25178674;BioNTech, Sinovac;26;1378
12.05.2021;13029;5072462;35167;4801291;232;43821;228192;14711273;119479;10637602;0;25348875;BioNTech, Sinovac;22;1225
13.05.2021;11534;5083996;55472;4856763;238;44059;201295;14732527;32148;10669750;0;25402277;BioNTech, Sinovac;22;1081
14.05.2021;11394;5095390;37261;4894024;242;44301;203073;14814316;77932;10747682;0;25561998;BioNTech, Sinovac;23;1060
15.05.2021;11472;5106862;38814;4932838;236;44537;204637;14895052;44693;10792375;0;25687427;BioNTech, Sinovac;22;1063
16.05.2021;10512;5117374;14418;4947256;223;44760;202243;14947740;32628;10825003;0;25772743;BioNTech, Sinovac;21;971
17.05.2021;10174;5127548;13864;4961120;223;44983;206836;14986982;138949;10963952;0;25950934;BioNTech, Sinovac;20;928
18.05.2021;11937;5139485;10125;4971245;203;45186;217276;15202819;370392;11334344;0;26537163;BioNTech, Sinovac;18;1053
19.05.2021;11553;5151038;9271;4980516;233;45419;218683;15366071;121045;11455389;0;26821460;BioNTech, Sinovac;20;1009
20.05.2021;9385;5160423;9271;4989787;207;45626;219192;15511277;116708;11572097;0;27083374;BioNTech, Sinovac;18;811
21.05.2021;9528;5169951;8852;4998639;214;45840;218846;15871547;301756;11873853;0;27745400;BioNTech, Sinovac;18;802
22.05.2021;8697;5178648;14472;5013111;231;46071;216658;15919759;25335;11899188;0;27818947;BioNTech, Sinovac;19;731
23.05.2021;7839;5186487;11202;5024313;197;46268;210291;16045835;103704;12002892;0;28048727;BioNTech, Sinovac;16;653
24.05.2021;7523;5194010;10003;5034316;178;46446;216655;16115588;42755;12045647;0;28161235;BioNTech, Sinovac;15;625
25.05.2021;9375;5203385;11192;5045508;175;46621;223104;16255095;97105;12142752;0;28397847;BioNTech, Sinovac;14;772
26.05.2021;8738;5212123;12205;5057713;166;46787;221214;16320454;48127;12190879;0;28511333;BioNTech, Sinovac;14;717
27.05.2021;8426;5220549;13102;5070815;183;46970;219465;16377100;37474;12228353;0;28605453;BioNTech, Sinovac;15;689
28.05.2021;7773;5228322;12284;5083099;164;47134;220162;16452864;48960;12277313;0;28730177;BioNTech, Sinovac;13;633
29.05.2021;7656;5235978;11180;5094279;137;47271;222613;16498868;26500;12303813;0;28802681;BioNTech, Sinovac;11;622
30.05.2021;6933;5242911;10763;5105042;134;47405;218957;16551775;105373;12409186;0;28960961;BioNTech, Sinovac;11;559
31.05.2021;6493;5249404;9582;5114624;122;47527;219461;16628831;133526;12542712;0;29171543;BioNTech, Sinovac;10;518
1.06.2021;7112;5256516;9457;5124081;129;47656;223482;16740180;92793;12635505;0;29375685;BioNTech, Sinovac;10;563
2.06.2021;7181;5263697;7372;5131453;112;47768;224150;16924374;97180;12732685;0;29657059;BioNTech, Sinovac;9;564
3.06.2021;6602;5270299;8540;5139993;114;47882;222847;17234801;161773;12894458;0;30129259;BioNTech, Sinovac;9;512
4.06.2021;6169;5276468;7617;5147610;94;47976;224681;17346890;77162;12971620;0;30318510;BioNTech, Sinovac;7;476
5.06.2021;6126;5282594;7161;5154771;92;48068;216156;17515705;88737;13060357;0;30576062;BioNTech, Sinovac;7;469
6.06.2021;5386;5287980;6003;5160774;96;48164;204827;17699837;97126;13157483;0;30857320;BioNTech, Sinovac;7;409
7.06.2021;5647;5293627;6576;5167350;91;48255;218164;17987842;100998;13258481;0;31246323;BioNTech, Sinovac;7;426
8.06.2021;6609;5300236;5836;5173186;86;48341;225527;18239386;91971;13350452;0;31589838;BioNTech, Sinovac;6;495
9.06.2021;6454;5306690;6647;5179833;87;48428;224193;18538800;98089;13448541;0;31987341;BioNTech, Sinovac;6;480
10.06.2021;6408;5313098;6895;5186728;96;48524;223320;18967237;91794;13540335;0;32507572;BioNTech, Sinovac;7;473
11.06.2021;6261;5319359;6217;5192945;69;48593;224128;19349257;63399;13603734;0;32952991;BioNTech, Sinovac;5;460
12.06.2021;6076;5325435;5112;5198057;75;48668;218758;19761182;63246;13666980;0;33428162;BioNTech, Sinovac;5;445
13.06.2021;5012;5330447;4194;5202251;53;48721;214957;20318690;67019;13733999;0;34052689;BioNTech, Sinovac;4;365
14.06.2021;5626;5336073;4585;5206836;74;48795;219290;20963316;80850;13814849;0;34778165;BioNTech, Sinovac;5;407
15.06.2021;5955;5342028;4186;5211022;84;48879;223846;22268007;158369;13973218;0;36241225;BioNTech, Sinovac;6;426
16.06.2021;6221;5348249;4632;5215654;71;48950;227163;23654078;111803;14085021;0;37739099;BioNTech, Sinovac;5;442
17.06.2021;5904;5354153;4143;5219797;62;49012;225064;25225946;135234;14220255;0;39446201;BioNTech, Sinovac;4;415
18.06.2021;5575;5359728;4427;5224224;59;49071;224128;26301413;97484;14317739;0;40619152;BioNTech, Sinovac;4;389
19.06.2021;5480;5365208;4195;5228419;51;49122;215496;26824612;52439;14370178;0;41194790;BioNTech, Sinovac;4;381
20.06.2021;5091;5370299;4219;5232638;63;49185;213297;28123248;119952;14490130;0;42613378;BioNTech, Sinovac;4;351
21.06.2021;5294;5375593;5093;5237731;51;49236;221052;29052236;86813;14576943;0;43629179;BioNTech, Sinovac;3;363
22.06.2021;6143;5381736;5214;5242945;57;49293;223238;29462165;41015;14617958;0;44080123;BioNTech, Sinovac;4;420
23.06.2021;5809;5387545;5917;5248862;65;49358;224192;30267732;65478;14683436;0;44951168;BioNTech, Sinovac;4;396
24.06.2021;5703;5393248;5846;5254708;59;49417;223385;31090069;58233;14741669;0;45831738;BioNTech, Sinovac;4;387
25.06.2021;5630;5398878;7184;5261892;56;49473;222936;31838965;53342;14795011;0;46633976;BioNTech, Sinovac;4;381
26.06.2021;5266;5404144;7402;5269294;51;49524;222561;32233753;50864;14845875;0;47079628;BioNTech, Sinovac;3;355
27.06.2021;4883;5409027;5937;5275231;52;49576;215294;32857375;69852;14915727;0;47773102;BioNTech, Sinovac;3;327
28.06.2021;5283;5414310;5327;5280558;58;49634;223525;33934402;88588;15004315;0;48938717;BioNTech, Sinovac;4;352
29.06.2021;5846;5420156;6536;5287094;53;49687;229846;34344798;52332;15056647;0;49401445;BioNTech, Sinovac;4;388
30.06.2021;5496;5425652;7191;5294285;45;49732;228163;35091645;161009;15217656;298841;50608142;BioNTech, Sinovac;3;361
1.07.2021;5288;5430940;6219;5300504;42;49774;225537;35315962;119173;15336829;559397;51212188;BioNTech, Sinovac;3;345
2.07.2021;4891;5435831;5352;5305856;55;49829;223782;35673239;186071;15522900;908579;52104718;BioNTech, Sinovac;4;315
3.07.2021;4537;5440368;4913;5310769;45;49874;218924;35828964;102751;15625651;1025309;52479924;BioNTech, Sinovac;3;290
4.07.2021;4418;5444786;4161;5314930;50;49924;216252;36084241;153485;15779136;1362933;53226310;BioNTech, Sinovac;3;280
5.07.2021;4678;5449464;4735;5319665;35;49959;219737;36416034;182933;15962069;1770087;54148190;BioNTech, Sinovac;2;293
6.07.2021;4679;5454763;4446;5324111;37;49996;226651;36736718;178128;16140197;2127310;55004225;BioNTech, Sinovac;2;290
7.07.2021;4680;5459923;4636;5328747;52;50048;225253;37028443;207550;16347747;2432480;55808670;BioNTech, Sinovac;3;286
8.07.2021;4681;5465094;5012;5333759;48;50096;226427;37318116;291727;16639474;2688867;56646457;BioNTech, Sinovac;3;281
9.07.2021;4682;5470764;5126;5338885;59;50155;228826;37530250;254518;16893992;2824592;57248834;BioNTech, Sinovac;3;277
10.07.2021;5530;5476294;5217;5344102;37;50192;224184;37644385;176842;17070834;2868205;57583424;BioNTech, Sinovac;2;324
11.07.2021;5261;5481555;5242;5349344;37;50229;222068;37811142;279266;17350100;2994217;58155459;BioNTech, Sinovac;2;303
12.07.2021;5404;5486959;5506;5354850;49;50278;227273;38090164;457950;17808050;3189430;59087644;BioNTech, Sinovac;3;303
13.07.2021;6285;5493244;5162;5360012;46;50324;234439;38337720;548362;18356412;3353863;60047995;BioNTech, Sinovac;3;342
14.07.2021;6907;5500151;5063;5365075;43;50367;238867;38538814;662309;19018721;3454394;61011929;BioNTech, Sinovac;2;363
15.07.2021;7304;5507455;5103;5370178;48;50415;232257;38786421;994409;20013130;3579278;62378829;BioNTech, Sinovac;2;365
16.07.2021;6918;5514373;5084;5375262;35;50450;229582;38808936;126093;20139223;3589345;62537504;BioNTech, Sinovac;2;344
17.07.2021;7666;5522039;5490;5380752;38;50488;234161;38900715;413664;20552887;3616775;63070377;BioNTech, Sinovac;2;373
18.07.2021;7680;5529719;5835;5386587;66;50554;233946;38965125;279314;20832201;3635120;63432446;BioNTech, Sinovac;3;369
19.07.2021;7667;5537386;4152;5390739;50;50604;226513;39038614;330556;21162757;3659520;63860891;BioNTech, Sinovac;2;362
20.07.2021;8780;5546166;4561;5395300;46;50650;198537;39047910;54387;21217144;3664592;63929646;BioNTech, Sinovac;2;414
21.07.2021;8151;5554317;4946;5400246;59;50709;184462;39145657;381332;21598476;3694744;64438877;BioNTech, Sinovac;3;377
22.07.2021;9586;5563903;5093;5405339;52;50761;214196;39277100;499185;22097661;3728131;65102892;BioNTech, Sinovac;2;434
23.07.2021;11094;5574997;5215;5410554;60;50821;219528;39320939;169578;22267239;3741365;65329543;BioNTech, Sinovac;3;498
24.07.2021;12381;5587378;5383;5415937;58;50879;221463;39413330;330374;22597613;3772354;65783297;BioNTech, Sinovac;3;548
25.07.2021;14230;5601608;5211;5421148;55;50934;223837;39597116;675410;23273023;3936386;66806525;BioNTech, Sinovac;2;611
26.07.2021;16809;5618417;5585;5426733;63;50997;224198;39836563;835484;24108507;4137920;68082990;BioNTech, Sinovac;3;697
27.07.2021;19761;5638178;7108;5433841;51;51048;246648;40071797;722120;24830627;4338114;69240538;BioNTech, Sinovac;2;796
28.07.2021;22291;5660469;4197;5438038;76;51124;257474;40330955;735544;25566171;4539615;70436741;BioNTech, Sinovac;3;872
29.07.2021;22161;5682630;5463;5443501;60;51184;261198;40661999;871822;26437993;4742842;71842834;BioNTech, Sinovac;2;838
30.07.2021;22083;5704713;5752;5449253;69;51253;256460;40929557;695232;27133225;4866860;72929642;BioNTech, Sinovac;3;814
31.07.2021;22332;5727045;5107;5454360;79;51332;259196;41012715;222408;27355633;4904319;73272667;BioNTech, Sinovac;3;816
1.08.2021;20890;5747935;5539;5459899;96;51428;251224;41062834;117189;27472822;4957403;73493059;BioNTech, Sinovac;3;760
2.08.2021;22898;5770833;5947;5465846;91;51519;270426;41165345;182970;27655792;5066244;73887381;BioNTech, Sinovac;3;828
3.08.2021;24832;5795665;6243;5472089;126;51645;256163;41303951;176131;27831923;5194348;74330222;BioNTech, Sinovac;5;892
4.08.2021;26822;5822487;6096;5478185;122;51767;262048;41306343;2224;27834147;5195214;74335704;BioNTech, Sinovac;4;964
5.08.2021;24297;5846784;6636;5484821;108;51875;245152;41346860;87354;27921501;5244520;74512881;BioNTech, Sinovac;4;870
6.08.2021;23957;5870741;6941;5491762;101;51976;243280;41490596;329357;28250858;5361024;75102478;BioNTech, Sinovac;4;848
7.08.2021;25100;5895841;6758;5498520;112;52088;246037;41632116;322097;28572955;5469207;75674278;BioNTech, Sinovac;4;878
8.08.2021;22699;5918540;5835;5504355;108;52196;239637;41726338;205038;28777993;5525059;76029390;BioNTech, Sinovac;4;789
9.08.2021;23731;5942271;7365;5511720;117;52313;245253;41874764;320290;29098283;5629012;76602059;BioNTech, Sinovac;4;816
10.08.2021;26597;5968868;14954;5526674;124;52437;264647;42333084;947348;30045631;5886502;78265217;BioNTech, Sinovac;4;885
11.08.2021;27356;5996224;16363;5543037;128;52565;278263;42732950;773711;30819342;6086828;79639120;BioNTech, Sinovac;4;888
12.08.2021;22261;6018485;15685;5558722;138;52703;281535;43304840;963653;31782995;6348176;81436011;BioNTech, Sinovac;4;700
13.08.2021;21372;6039857;16492;5575214;157;52860;285242;43493299;312258;32095253;6432976;82021528;BioNTech, Sinovac;5;666
14.08.2021;19949;6059806;15364;5590578;145;53005;284947;43784866;451659;32546912;6533719;82865497;BioNTech, Sinovac;4;613
15.08.2021;18847;6078653;14426;5605004;154;53159;281184;43946656;260906;32807818;6584153;83338627;BioNTech, Sinovac;5;574
16.08.2021;18163;6096816;16642;5621646;165;53324;287947;44187137;332581;33140399;6728151;84055687;BioNTech, Sinovac;5;548
17.08.2021;21692;6118508;14636;5636282;183;53507;294561;44522947;417186;33557585;6923738;85004270;BioNTech, Sinovac;5;646
18.08.2021;19944;6138452;15537;5651819;168;53675;295206;45025676;570522;34128107;7259939;86413722;BioNTech, Sinovac;5;584
19.08.2021;19320;6157772;14743;5666562;216;53891;292538;45304742;317908;34446015;7444817;87195574;BioNTech, Sinovac;6;561
20.08.2021;19918;6177690;15561;5682123;204;54095;293252;45636614;345587;34791602;7631224;88059440;BioNTech, Sinovac;6;572
21.08.2021;19351;6197041;13163;5695286;232;54327;282857;45796679;172138;34963740;7682931;88443350;BioNTech, Sinovac;7;553
22.08.2021;18622;6215663;13263;5708549;206;54533;265196;45936819;135504;35099244;7724462;88760525;BioNTech, Sinovac;6;531
23.08.2021;18857;6234520;15833;5724382;232;54765;282528;46317869;309439;35408683;7924605;89651157;BioNTech, Sinovac;7;533
24.08.2021;19191;6253711;15373;5739755;230;54995;293037;46649044;264131;35672814;8083879;90405737;BioNTech, Sinovac;6;538
25.08.2021;19970;6273681;16651;5756406;217;55212;296711;46949549;235739;35908553;8223445;91081547;BioNTech, Sinovac;6;556
26.08.2021;19616;6293297;15205;5771611;257;55469;297068;47247097;237338;36145891;8354557;91747545;BioNTech, Sinovac;7;543
27.08.2021;18340;6311637;14528;5786139;244;55713;295647;47528894;242884;36388775;8473334;92391003;BioNTech, Sinovac;7;504
28.08.2021;17912;6329549;12175;5798314;245;55958;290186;47675684;132872;36521647;8513043;92710374;BioNTech, Sinovac;7;490
29.08.2021;17332;6346881;11396;5809710;255;56213;286425;47797199;114643;36636290;8571367;93004856;BioNTech, Sinovac;7;473
30.08.2021;19557;6366438;13401;5823111;245;56458;283250;47929111;129291;36765581;8623646;93318338;BioNTech, Sinovac;7;532
31.08.2021;21893;6388331;14106;5837217;252;56710;297167;48271065;324020;37089601;8806888;94167554;BioNTech, Sinovac;7;590
1.09.2021;23946;6412277;15164;5852381;290;57000;302869;48563507;278507;37368108;8942269;94873884;BioNTech, Sinovac;8;641
2.09.2021;23496;6435773;20004;5872385;283;57283;305047;48854935;277064;37645172;9065199;95565306;BioNTech, Sinovac;8;624
3.09.2021;22857;6458630;14527;5886912;276;57559;304530;49197925;331628;37976800;9203658;96378383;BioNTech, Sinovac;7;602
4.09.2021;20033;6478663;19464;5906376;278;57837;283385;49376328;164642;38141442;9243438;96761208;BioNTech, Sinovac;7;525
5.09.2021;19391;6498054;24289;5930665;269;58106;279063;49551529;146887;38288329;9273439;97113297;BioNTech, Sinovac;7;506
6.09.2021;20962;6519016;29327;5959992;271;58377;301164;49946816;340416;38628745;9406034;97981595;BioNTech, Sinovac;7;543
7.09.2021;23638;6542654;34402;5994394;274;58651;304864;50324643;349796;38978541;9525462;98828646;BioNTech, Sinovac;7;606
8.09.2021;23914;6566568;30103;6024497;262;58913;308437;50648789;319855;39298396;9635422;99582607;BioNTech, Sinovac;7;609
9.09.2021;23846;6590414;31322;6055819;257;59170;314793;50930700;301452;39599848;9737377;100267925;BioNTech, Sinovac;6;602
10.09.2021;23562;6613976;35083;6090902;214;59384;318835;51234095;363388;39963236;9851336;101048667;BioNTech, Sinovac;5;590
11.09.2021;22923;6636899;30144;6121046;259;59643;314046;51411717;195137;40158373;9884664;101454754;BioNTech, Sinovac;6;571
12.09.2021;21352;6658251;25616;6146662;243;59886;310546;51536013;147339;40305712;9906933;101748658;BioNTech, Sinovac;6;530
13.09.2021;24613;6682864;26052;6172714;231;60117;319110;51780811;330212;40635924;10014872;102431607;BioNTech, Sinovac;6;606
